111111111111111111
10C0100010C0100001
1000P11010C0100011
1C00100E10C0100111
100000000000000001
10C010001000000000
1000C11010C0100011
1C00100010C0100011
111111111111111111