111111111
10C000001
1000P1001
1C00001E1
111111111