111111111111
10C0000E1001
1001P1101001
100010001001
111111111111