111111111
10C000001
1000P0101
1000000E1
111111111