111111111
10C000001
1000P0101
1C00000E1
111111111