111111111111111111
1CC0000000000000E1
101111111111111111
1C0000000000000001
111111111111111101
10C000000000000001
101111111111111111
1C00000000C00000P1
111111111111111111