111111111111111111
1CC0000000010000C1
101C11011111E11111
1C0000000000000001
1111C0011111111101
10C000000000000001
101111100111111001
1C00000000C00000P1
111111111111111111