111111111
10C010001
1001P1101
1C00100E1
111111111